20
19
0 0 0 0 0 0 13 13 13 13 13 13 13 13 13 13 13 13 13 13 13
0 0 0 0 0  0 13 13 13 13 13 13 13 13 13 13 13 13 13 13
0 0 0 0 0 13 13 13 13 13 13 13 13 13 13 13 13 13 13 13 13
0 0 0 0 0 0  0  0  0  0  0  0  0  0  0  0  0  0  0  0  0  0
13 13 13  0 13 13 13 13 13 13 13 13 13 13 13 13 13 13 13 13
13 13 13  0 13 13 13 13 13 13 13 13 13 13 13 13 13 13 13 13
13 13 13  0  0  0 13 13 13 13 13 13 13 13 13 13 13 13 13 13
13 13 13 13 13  0 13 13 13 13 13 13 13 13 13 13 13 13 13 13
13 13 13 13 13 13 13 13 13 13 13 13 13 13 13 13 13 13 13 13
13 13 13 13 13 13 13 13 13 13 13 13 13 13 13 13 13 13 13 13
13 13 13 13 13 13 13 13 13 13 13 13 13 13 13 13 13 13 13 13
13 13 13 13 13 13 13 13 13 13 13 13 13 13 13 13 13 13 13 13
13 13 13 13 13 13 13 13 13 13 13 13 13 13 13 13 13 13 13 13
13 13 13 13 13 13 13 13 13 13 13 13 13 13 13 13 13 13 13 13
13 13 13 13 13 13 13 13 13 13 13 13 13 13 13 13 13 13 13 13
13 13 13 13 13 13 13 13 13 13 13 13 13 13 13 13 13 13 13 13
13 13 13 13 13 13 13 13 13 13 13 13 13 13 13 13 13 13 13 13
13 13 13 13 13 13 13 13 13 13 13 13 13 13 13 13 13 13 13 13
13 13 13 13 13 13 13 13 13 13 13 13 13 13 13 13 13 13 13 13

