20
14
13 19 15 15 15 15 21 13 19 15 21 13 19 15 15 15 15 15 21 13 
13 18 14 14 14 14 20 13 18 14 20 13 18 14 14 14 14 14 20 13 
13  0  0  0  0  0  0 17  1  1  1 17  1  1  1  1  1  1  1 13 
13  0  0  0  0  0  0 16  1  1  1 16  1  1  1  1  1  1  1 13 
13  0  0  0  0  0  0  2  1  1  1  1  1  1  1  1  1  1  1 13 
13  0  0  0  0  0  0 13 13 13 13 13  1  1  1  1  1  1  1 13 
13  0  0  0  0  0  0 13 19 19 13 13  1  1  1  1  1  1  1 13 
13  0  0  0  0  0  0 13 18 18 13 13  1  1  1 13 13 13 13 13 
13  0  0  0  0  0  0 13  1  1  1  1  1  1  1 19 15 15 21 13 
13  0  0  0  0  0  0 13  1  1  1  1  1  1  1 18 14 14 20 13 
13  0  0  0  0  0  0 13  1  1  1  1  1  1  1  1  1  1  1 17 
13  0  0  0  0  0  0 13  1  1  1  1  1  1  1  1  1  1  1 16 
13  0  0  0  0  0  0 13  1  1  1  1  1  1  1  1  1  1  1  1 
13 13 13 13 13 13 13 13 13 13 13 13 13 13 13 13 13 13 13 13 

