20
14
13 13 13 13 13 13 13 13 13 13 13 13 13 13 13 13 13 13 13 13 
13 19  15 15 15 6  6 15 15 15 13 15  6  6 15 15 15 15 21 13 
13 18 14  4 14  5  5 14  4 14 17 14  5  5  4  9 10  4 20 13 
13  1  1  3  1  1  1  1  3  1 16  1  1  1  3  7  8  3  1 13 
13  1  1  1  1  1  1  1  1  1  1  1  1  1  1  1  1  1  1 13 
13  1  1  1  1  1  1  1  1  1  1  1  1  1  1  1  1  1  1 13 
13 13 13 13 13 13  1  1 13 13 13 13 13  1  1 13 13 13 13 13 
13 15 15 15 15 21  1  1 19 15 15 15 21  1  1 19 15 15 21 13 
13 14 14  4 14 20  1  1  4  9 10  4 20  1  1 18  4 14 20 13 
13  1  1  3  1  1  1  1  3  7  8  3  1  1  1  1  3  1  1 13 
15  1  1  1  1  1  1  1  1  1  1  1  1  1  1  1  1  1  1 13 
14  1  1  1  1  1  1  1  1  1  1  1  1  1  1  1  1  1  1 13 
1   1  1  1  1  1  1  1  1  1  1  1  1  1  1  1  1  1  1 13 
13 13 13 13 13 13 13 13 13 13 13 13 13 13 13 13 13 13 13 13 