20
14
13 13 13 13 13 13 13 13 13 13 13 13 13 13 13 13 13 13 13 13 
13 19 15 15 15 15 15  6 15 15  6 15 15 21 13 15 15 15 21 13 
13 18  4  9 10  9 10  5  9 10  5  4 14 20 13  9 10  4 20 13 
13  1  3  7  8  7  8  1  7  8  1  3  1  1 17  7  8  3  1 17 
13  1  1  1  1  1  1  1  1  1  1  1  1  1 16  1  1  1  1 16 
13  1  1  1  1  1  1  1  1  1  1  1  1  1  1  1  1  1  1  1 
13  1 29  1 29  1 29  1 29  1 29  1 29  1 13  2  1  1  1 13 
13  1 28  1 28  1 28  1 28  1 28  1 28  1 13 13 13 13 13 13 
13  1  1  1  1  1  1  1  1  1  1  1  1  1 19 15 15 15 21 13 
13  1 29  1 29  1 29  1 29  1 29  1 29  1 18  9 10  4 20 13 
17  1 28  1 28  1 28  1 28  1 28  1 28  1  1  7  8  3  1 13 
16  1  1  1  1  1  1  1  1  1  1  1  1  1  1  1  1  1  1 13 
1   1  1  1  1  1  1  1  1  1  1  1  1  1  1  1  1  1  1 13 
13 13 13 13 13 13 13 13 13 13 13 13 13 13 13 13 13 13 13 13 