20
14
13 13 13 13 13 13 13 13 13 13 13 13 13 13 13 13 13 13 13 13 
13 19  6 15 15  6 15 15 15 15 13 15 15  6 15 15 15 15 21 13 
13 18  5 14 14  5 14 14  4 14 17 14  4  5  4  9 10  4 20 13 
13  1  1  1  1  1  1  1  3  1 16  1  3  1  3  7  8  3  1 13 
13  1  1  1  1  1  1  1  1  1  1  1  1  1  1  1  1  1  1 13 
13  1  1  1  1  1  1  1  1  1  1  1  1  1  1  1  1  1  1 13 
13 13 13 13 13 13  1  1 13 13 13 13 13  1  1 13 13 13 13 13 
13 15 15 15 15 21  1  1 19 15 15 15 21  1  1 19 15 15 21 13 
13 14 14  4 14 20  1  1  4  9 10  4 20  1  1 18 14  4 20 13 
13  1  1  3  1  1  1  1  3  7  8  3  1  1  1  1  1  3  1 13 
15  1  1  1  1  1  1  1  1  1  1  1  1  1  1  1  1  1  1 17 
14  1  1  1  1  1  1  1  1  1  1  1  1  1  1  1  1  1  1 16 
1   1  1  1  1  1  1  1  1  1  1  1  1  1  1  1  1  1  1  1 
13 13 13 13 13 13 13 13 13 13 13 13 13 13 13 13 13 13 13 13 