20
14
13 13 13 13 13 13 13 13 13 13 13 13 13 13 13 13 13 13 13 13 
13 19 15 15 15 15 15 15 13 15 15 15 15 15 15 15 15 15 21 13 
13 18 14  4 38  4 14 14 13 14 14  4  9 10 14  9 10  4 20 13 
13  1  1  3 37  3  1  1 13  1  1  3  7  8  1  7  8  3  1 13 
13  1 39 39 39 39 39  1 13  1  1  1  1  1  1  1  1  1  1 13 
13  1 39 39 39 39 39  1 13  1  1  1  1  1  1  1  1  1  1 13 
13  1 39 39 39 39 39  1 13  1  1  1  1 26 27  1  1 26 27 13 
13  1 39 39 39 39 39  1 13  1  1  1  1  1  1  1  1  1  1 13 
13  1  1  1  1  1  1  1 13  1  1  1  1 26 27  1  1 26 27 13 
13 13 13  1  1  1 13 13 13  1  1  1  1  1  1  1  1  1  1 13 
19 15 21  1  1  1 19 15 21  1  1  1  1 26 27  1  1 26 27 13 
18 14 20  1  1  1 18 14 20  1  1  1  1  1  1  1  1  1  1 13 
1   1  1  1  1  1  1  1  1  1  1  1  1  1  1  1  1  1  1 13 
13 13 13 13 13 13 13 13 13 13 13 13 13 13 13 13 13 13 13 13 