20
14
13 13 13 13 13 13 13 13 13 13 13 13 13 13 13 13 13 13 13 13 
13 19 15 15 15  6  6 15 15 15 15 15 13  6 15 15 15 15 21 13 
13 18 14 14 14  5  5 14 14 14 14 14 13  5  4  9 10  4 20 13 
13  1  1  1  1  1  1  1  1  1  1  1 13  1  3  7  8  3  1 13 
13  1  1  1 13 13 13  1  1  1 26 27 13  1  1  1  1  1  1 13 
13  1  1  1 19 15 13  1  1  1  1  1 13  1  1  1  1  1  1 13 
13  1  1  1 18 14 13  1  1  1 26 27 13  1  1  1  1  1  1 13 
13  1  1  1  1  1 13  1  1  1  1  1 13  1  1  1  1  1  1 13 
13  1  1  1 26 27 13  1  1  1 26 27 13 13 13  1  1 13 13 13 
13  1  1  1  1  1 13  1  1  1  1  1 19 15 21  1  1 19 21 13 
15  1  1  1 26 27 13  1  1  1  1  1 18 14 20  1  1 18 20 13 
14  1  1  1  1  1 13  1  1  1  1  1  1  1  1  1  1  1  1 13 
1   1  1  1 26 27 13  1  1  1  1  1  1  1  1  1  1  1  1 13 
13 13 13 13 13 13 13 13 13 13 13 13 13 13 13 13 13 13 13 13 