20
14
13 13 13 13 13 13 13 13 13 13 13 13 13 13 13 13 13 13 13 13 
13 13 13 13 13 13 13 13 13 13 13 13 13 13 13 13 13 13 13 13 
13 13 13 13 19 15  6  6 15 21 13 19  6  6 21 13 13 13 13 13 
13 13 13 13 18  4  5  5  4 20 13 18  5  5 20 13 13 13 13 13 
13 13 13 13  0  2  0  0  2  0 17  1  1  1  1 13 13 13 13 13 
13 13 13 13  0  0  0  0  0  0 16  1  1  1  1 13 13 13 13 13 
13 13 13 13  0  0  0  0  0  0  1  1  1  1  1 13 13 13 13 13 
13 13 13 13  0 29  0  0  0  0 13  1  1  1  1 13 13 13 13 13 
13 13 13 13  0 28  0  0  0  0 13  1  1  1  1 19 15 15 15 21 
13 13 13 13  0  0  0  0  0  0 13  1  1  1  1 18 14 14 14 20 
13 13 13 13  0  0  0  0  0  0 13  1  1  1  1  1  1  1  1  1 
13 13 13 13 13 13 13 13 13 13 13 13 13 13 13 13 13 13 13 13 
13 13 13 13 13 13 13 13 13 13 13 13 13 13 13 13 13 13 13 13
13 13 13 13 13 13 13 13 13 13 13 13 13 13 13 13 13 13 13 13 