20
14
13 13 13 13 13 13 13 13 13 13 13 13 13 13 13 13 13 13 13 13 
13 13 13 13 13 13 13 13 13 13 13 13 13 13 13 13 13 13 13 13 
13 13 13 13 19 15  6  6 15 21 13 19  6  6 21 13 13 13 13 13 
13 13 13 13 18  4  5  5  4 20 13 18  5  5 20 13 13 13 13 13 
13 13 13 13  1  3  1  1  3  1 17  1  1  1  1 13 13 13 13 13 
13 13 13 13  1 29  1  1  1  1 16  1 26 27  1 13 13 13 13 13 
13 13 13 13  1 28  1  1  1  1  1  1  1  1  1 13 13 13 13 13 
13 13 13 13  1  1  1  1  1  1 13  1  1  1  1 13 13 13 13 13 
13 13 13 13  1  1  1  1  1  1 13  1  1  1  1 19 23 25 15 21 
13 13 13 13 13 13 13 13 13 13 13  1  1  1  1 18 22 24 14 20 
13 13 13 13 13 13 13 13 13 13 13  1  1  1  1  1  1  1  1  1 
13 13 13 13 13 13 13 13 13 13 13 13 13 13 13 13 13 13 13 13 
13 13 13 13 13 13 13 13 13 13 13 13 13 13 13 13 13 13 13 13
13 13 13 13 13 13 13 13 13 13 13 13 13 13 13 13 13 13 13 13 
